3333333333333333333333333333333333333333333333333333333333333331111111311111111111110000000000000000000000000000000000000000111111111111111111111111111111111111
3333333333333333333333333333333333333333333333333333333333333331111111111111111111110000000000000000000000000000000000000000111111111111111111111111111111111111
3333333333333333333333333333333333333333333333333333333333333331111111111111111111110000000000000000000000000000000000000000111111111111111111111111111111111111
3333333333333333333333333333333333333333333333333333333333333331111111111111111111111000000000000000000000000000000000000001111111111111111111111111111111111111
3333333333333333333333333333333333333333333333333333333333333331111111111111111111111100000000000000000000000000000000000011111111111111111111111111111111111111
3333333333333333333333333333333333333333333333333333333333333331111111111111111111111110000000000000000000000000000000000011111111222211222111111111111111111113
3333333333333333333333333333333333333333333333333333333333333331111111111111111111111111100000000000000000000000000000000011111112222222222111111111111111111113
3333333333333333333333333333333333333333333333333333333333333331111111111111111111111111100000000000000000000000000000000011122222222222222211111111111111113333
3333333333333333333333333333333333333333333333333333333333333333111111111133331111111111100000000000000000000000000000000111222222222222222221111111111113333333
3333333333333333333333333333333333333333333333333333333333333333311111111133333111111111110000000000000000000000000000000111222222222222222222111111111113333333
3333333333333333333333333333333333333333333333333333333333333333331111111133333311111111110000000000000000000000000000001111222222222222222222111111111133333333
3333333333333333333333333333333333333333333333333333333333333333331111111133333333111111111000000000111000111111111111111111122222222222222221111111111133333333
3333333333333333333333333333333333333333333333333333333333333333311111111333333333111111111111100001111111111111111111111111122222222222222221111111111133333333
3333333333333333333333333333333333333333333333333333333333333333311111111333333333111111111111111111111111111111111111111111122222222222222211111111111133333333
3333333333333333333333333333333333333333333333333333333333333333311111111333333333111111111111111111111111111111111111111111122222222222222211111111111133333333
3333333333333333333333333333333333333333333333333333333333333333311111111333333333111111111111111111111111111111111111111111112222222222222111111111111333333333
3333333333333333333333333333333333333333333333333333333333333333311111111333333333111111111111111113333333331111111111111111112222222222221111111111111111333333
3333333333333333333333333333333333333333333333333333333333333333311111111133333331111111111111113333333333333333333111111111112222222222221111111111111111111333
3333333333333333333333333333333333333333333333333333333333333333311111111113333331111111111111333333333333333333333111111111112222222222211111111111111111111111
3333333333333333333333333333333333333333333333333333333333333333111111111113333311111111111113333333333333333333333333111111111222222222211111333311111111111111
3333333111111111133333333333333333333333333333333333333333333331111111111113333311111111111113333333333333333333333333311111111222222222211111333333331111111111
3333333111111111111133333333333333333333333333333333333333333331111111111111131111111111111133333333333333333333333333311111111222222222111111333333333333111111
3333333111111111111113333333333333333333333333333333333333333331111111111111111111111111111133333333333333333333333333311111111222222221111113333333333333331111
3333311111111111111113333333333333333333333333333333333333333331111111111111111111111111111133333333333333333333333333311111111122222111111133333333333333333111
3333111111111111111113333333333333333333333333333333333333333331111111111111111111111111111133333333333333333333333333311111111122221111111333333333333333333333
3333111111111111111113333333333333333333333333333333333333333331111111111111111111111111111133333333333333333333333333111111111111111111113333333333333333333333
3333111111111111111111111111133333333333333333333333333333333311111111112211111111111111111133333333333333333333333333111111111111111111111333333333333333333333
3333111111111111111111111111111333333333333333333333333333333311111111122221111111111111111113333333333333333333333331111111111111111111111113333333333333333333
3333111111111111111111111111111113333333333333333333333333333311111111222222112222111111111111333333333333333333333311111111111111111111111111333333333333333333
3333111111111111111111111111111111333333333333333333333333333311111112222222222222211111111111333333333333333333333111111111111111111111111111133333333333333333
3333111111111111111111111111111111333333333333333333333333333333111112222222222222211111111111133333333333333333331111111111111111111111111111113333333333333333
3333111111111111111111111111111111333333333333333333333333333333111112222222222222221111111111113333333333333333111111111111111111111111111111111133333333333333
3333111111111111111111111111111111133333333333333333333333333333111122222222222222221111111111111111333333333311111111111111111113111111111111111113333333333333
3333111111111111113333333111111111133333333333333333333333333333111122222222222222221111111111111111111111111111111111111111111333331111111111111111333333333333
3333111111111111133333333311111111133333333333333333333333333333111122222222222222221111111111111111111111111111111111111111111333333331111111111111133333333333
3333111111111111133333333331111111133333333333333333333333333331111222222222222222221111111111111111111111111111111111111111113333333333111111111111133333333333
3333111111111111133333333331111111133333333333333333333333333331111222222222222222221111111111111111111111111111111111111111113333333333331111111111113333333333
3333111111111111133333333331111111133333333333333333333333333311112222222222222222221111111111111111111111111111111111111111133333333333333311111111111333333333
3333311111111111133333333331111111333333333333333333333333333311112222222222222222221111111111111111111111111111111111111111133333333333333333111111111133333333
3333311111111111113333333331111111333333333333333333333333333311112222222222222222211111111111111111111111111111111111111111111333333333333333333311111133333333
3333311111111111111133333331111111133333333333333333333333333111112222222222222222211111111111111111111111111133333333311111111111133333333333333331111133333333
3333311111111111111111333111111111133333333333333333333333333111111222222222222222111111111333331111111111111333333333311111111111111333333333333331111133333333
3333331111111111111111111111111111133333333333333333333333331111111111222222222111111111111333333333111111113333333333331111111111111133333333333333311333333333
3333331111111111111111111111111111133333333333333333333333331111111111111122221111111111111333333333311111113333333333331111111111111113333333333333333333333333
3333331111111111111111111111111111133333333333333333333333331111111111111111111111111111111333333333311111113333333333331111111111111113333333333333333333333333
3333333111111111111111111111111111133333333333333333333333311111111111111111111111111111111333333333311111113333333333331111111111111111333333333333333333333333
3333333111111111111111111111111111133333333333333333333333311111111111111111111111111111111333333333311111111333333333331111111111111111133333333333333333333333
3333333311111111111111111111111111333333333333333333333333311111111111111111111111111111111133333333311111111133333333311111111111111111113333333333333333333333
3333333333311111111111111111111111333333333333333333333333311111111111111111111333111111111113333333311111111111133311111111111111111111111333333333333333333333
3333333333331111111111111111111113333333333333333333333333331111111111113333333333311111111113333333311111111111111111111111111111111111111133333333333333333333
3333333333333333333333333333333333333333333333333333333333333333333333333333333333331111111111111333311111111111111111111111111111111111111113333333333333333333
3333333333333333333333333333333333333333333333333333333333333333333333333333333333333111111111111111111111111111111111111111111111111111111111333333333333333333
3333333333333333333333333333333333333333333333333333333333333333333333333333333333333311111111111111111111111111111111111111111111111111111111333333333333333333
3333333333333333333333333333333333333333333333333333333333333333333333333333333333333311111111111111111111111111111111113331111111111111111111333333333333333333
3333333333333333333333333333333333333333333333333333333333333333333333333333333333333311111111111111111111111111111133333333333333333333311113333333333333333333
3333333333333333333333333333333333333333333333333333333333333333333333333333333333333311111111111111111111111111111133333333333333333333333333333333333333333333
3333333333333333333333333333333333333333333333333333333333333333333333333333333333333111111111111111111111111111111333333333333333333333333333333333333333333333
3333333333333333333333333333333333333333333333333333333333333333333333333333333333333111111111111111111111111111113333111111333333333333333333333333333333333333
3333333333333333333333333333333333333333333333333333333333333333333333333333333333333111111111111311111111111111133331111111133333333333333333333333333333333333
3333333333333333333333333333333333333333333333333333333333333333333333333333333333331111111111111333111111111111333311111111113333333333333333333333333333333333
3333333333333333333333333333333333333333333333333333333333333333333333333333333333331111111111113333311111111113333111111111113333333333333333333333333333333333
3333333333333333333333333333333333333333333333333333333333333333333333333333333333331111111111113333331111111113333111111111111333333333333333333333333333333333
3333333333333333333333333333333333333333333333333333333333333333333333333333333333331111111111133333331111111133331111111111111133333333333333333333333333333333
3333333333333333333333333333333333333333333333333333333333333333333333333333333333333111111111333333331111111333331111100001111133333333333333333333333333333333
3333333333333333333333333333333333333333333333333333333333333333333333333333333333333111111113333333333111111333311111000000111133333333333333333333333333333333
3333333333333333333333333333333333333333333333333333333333333333333333333333333333333331111133333333333111113333311110000000011133333333333333333333333333333333
3333333333333333333333333333333333333333333333333333333333333333333333333333333333333333111333333333333331133333111110000000001133333333333333333333333333333333
3333333333333333333333333333333333333333333333333333333333333333333333333333333333333333333333333333333333333333111100000000001113333333333333333333333333333333
3333333333333333333333333333333333333333333333333333333333333333333333333333333333333333333333333333333333333333111000000000000111333333333333333333333333333333
3333333333333333333333333333333333333333333333333333333333333333333333333333333333333333333333333333333333333333111000000000000011111113333333333333333333333333
3333333333333333333333333333333333333333333333333333333333333333333333333333333333333333333333333333333333333333111000000000000011111111133333333333333333333333
3333333333333333333333333333333333333333333333333333333333333333333333333333333333333333333333333333333333333333111000000000000000000011113333333333333333333333
3333333333331111111111111111113333333333333333333333333333333333333333333333333333333333333333333333333333333333311100000000000000000000111111111333333333333333
3333333333111111111111111111111133333333333333333333333333333333333333333333333333333333333333333333333333333333311000000000000000000000011111111133333333333333
3333333331111111111111111111111111333333333333333333333333333333333333333333333333333333333333333333333333333333311000000000000000000000011111111113333333333333
3333333311111111111111111111111111113333333333333333333333333333333333333333333333333333333333333333333333333333110000000000000000000000011111111111333333333333
3333333311111111111111111111111111111333333333333333333333333333333333333333333333333333333333333333333333333331110000000022222222220000011111111111333333333333
3333331111111111111111111111111111111111133333333333333333333333333333333333333333333333333333333333333333333331111000022222222222222222211111111111333333333333
3333311111111111111111111111111111111111111111333333333333333333333333333333333333333333333333333333333333333331111000122222222222222222222111111111333333333333
3333311111111111111111111111111111111111111111133333333333333333333333333333333333333333333333333333333333333331111111222222222222222222222111111111333333333333
3333311111111111111111111111111111111111111111133333333333311111111111133333333333333333333333333333333333333331111111222222222222222222222111111111133333333333
3333311111111111111122222211111111111111111111133333333311111111111111113333333333333333333333333333333333333331111111222222222222222222222211111111133333333333
3333311111111111111222222222111111111111111111133333331111111111111111113333333333333333333333333333333333333331111111222222222222222222222211111111133333333333
3333311111111111111222222222211111111111111111113333331111111000000011111133333333333333333333333333333333333331111111222222222222222222222211111111133333333333
3333311111111111111122222222211111111111111111111333331111100000000000011113333333333333333333333333333333333331111111122222222222222222222111111111133333333333
3333311111111111111111122222211111111111111111111333331111000000000000001111333333333333333333333333333333333331111111111222222222111111111111111111133333333333
3333311111111111111111111221111111111111111111111333311111000000000000001111133333333333333333333333333333333331111111111111111111111111111111111133333333333333
3333331111111111111111111111111111111111111111111333111111000000000000001111133333333333333333333333333333333331111111111111111111111111111111111333333333333333
3333333111111111111111111111111111111111111111111333111111100000000000001111133333333333333333333333333333333331111111111111111111111111111111111333333333333333
3333333331111111111111111111111111111111111111111333111111111100000000011111133333333333333333333333333333333333111111111111111111111111111111113333333333333333
3333333333311111111111111111111111111111111111113333311111111111111111111111133333333333333333333333333333333333311111111111111111111111111111133333333333333333
3333333333333111111111111111111111111111111111113333333311111111111111111111333333333333333333333333333333333333333333311111111111111111111111333333333333333333
3333333333333333111111111111111111111111111111133333333333333333333333333333333333333333333333333333333333333333333333333333333111111111111333333333333333333333
3333333333333333333311111111111111111111111111333333333333333333333333333333333333333333333333333333333333333333333333333333333333333333333333333333333333333333
3333333333333333333333333111111111111111111333333333333333333333333333333333333333333333333333333333333333333333333333333333333333333333333333333333333333333333
3333333333333333333333333333333333333111113333333333333333333333333333333333333333333333333333333333333333333333333333333333333333333333333333333333333333333333
3333333333333333333333333333333333333333333333333333333333333333333333333333333333333333333333333333333333333333333333333333333333333333333333333333333333333333
3333333333333333333333333333333333333333333333333333333333333333333333333333333333333333333333333333333333333333333333333333333333333333333333333333333333333333
3333333333333333333333333333333333333333333333333333333333333333333333333333333333333333333333333333333333333333333333333333333333333333333333333333333333333333
3333333333333333333333333333333333333333333333333333333333333333333333333333333333333333333333333333333333333333333333333333333333333333333333333333333333333333
